###############################
#  oo oo        o   o  o  oo  #
# ############## ##############
#  o            o       ooo   #
#  #### #############         #
# o   # #    ooo        o     #
#     # #############         #
#   o      o          ooo oo  #
###############################